XXXXXXXXXXXXXXXXXXXXXXXXXXXXXXXXXXXXXXXXX
X......................................FX
X.......................................X
X.......................................X
X.......................................X
X.......................................X
X.......................................X
X.......................................X
X.......................................X
X.......................................X
X.......................................X
X.......................................X
X.......................................X
X.......................................X
X.......................................X
X.......................................X
X.......................................X
X.......................................X
X.......................................X
X.......................................X
X.......................................X
X.......................................X
X.......................................X
X.......................................X
X.......................................X
X.......................................X
X.......................................X
X.......................................X
X.......................................X
X.......................................X
X.......................................X
X.......................................X
X.......................................X
X.......................................X
X.......................................X
X.......................................X
X.......................................X
X.......................................X
X.......................................X
XI......................................X
XXXXXXXXXXXXXXXXXXXXXXXXXXXXXXXXXXXXXXXXX