MMMMMMMMMMMMMMMMMMMMMMMMMMMMMMMMMMMMMMMMM
MMMMMMMMMMMMMMMMMMMMMMMMMMMMMMMMMMMMMMMMM
MMMMMMMMMMMMMMMMMMMMMMMMMMMMMMMMMMMMMMMMM
MMM...................................MMM
MMM.................................F.MMM
MMM...................................MMM
MMM...MMMMMMMMMMMMMMMMMMMMMMMMMMMMMMMMMMM
MMM...MMMMMMMMMMMMMMMMMMMMMMMMMMMMMMMMMMM
MMM...................................MMM
MMM...................................MMM
MMM...................................MMM
MMMMMMMMMMMMMMMMMMMMMMMMMMMMMMMMMMM...MMM
MMMMMMMMMMMMMMMMMMMMMMMMMMMMMMMMMMM...MMM
MMMMMMMMMMMMMMMMMMMMMMMMMMMMMMMMMMM...MMM
MMMMMMMMMMMMMMMMMMMMMMMMMMMMMMMMMMM...MMM
MMMMMMMMMMMMMMMMMMMMMMMMMMMMMMMMMMM...MMM
MMM...................................MMM
MMM...................................MMM
MMM...................................MMM
MMM...MMMMMMMMMMMMMMMMMMMMMMMMMMMMMMMMMMM
MMM...MMMMMMMMMMMMMMMMMMMMMMMMMMMMMMMMMMM
MMM...MMMMMMMMMMMMMMMMMMMMMMMMMMMMMMMMMMM
MMM...MMMMMMMMMMMMMMMMMMMMMMMMMMMMMMMMMMM
MMM...................................MMM
MMM...................................MMM
MMM...................................MMM
MMMMMMMMMMMMMMMMMMMMMMMMMMMMMMMMMMM...MMM
MMMMMMMMMMMMMMMMMMMMMMMMMMMMMMMMMMM...MMM
MMMMMMMMMMMMMMMMMMMMMMMMMMMMMMMMMMM...MMM
MMMMMMMMMMMMMMMMMMMMMMMMMMMMMMMMMMM...MMM
MMM...................................MMM
MMM...................................MMM
MMM...................................MMM
MMM...MMMMMMMMMMMMMMMMMMMMMMMMMMMMMMMMMMM
MMM...MMMMMMMMMMMMMMMMMMMMMMMMMMMMMMMMMMM
MMM...MMMMMMMMMMMMMMMMMMMMMMMMMMMMMMMMMMM
MMM........................R..........MMM
MMM........................RRR......I.MMM
MMM...................................MMM
MMMMMMMMMMMMMMMMMMMMMMMMMMMMMMMMMMMMMMMMM
MMMMMMMMMMMMMMMMMMMMMMMMMMMMMMMMMMMMMMMMM
MMMMMMMMMMMMMMMMMMMMMMMMMMMMMMMMMMMMMMMMM