MMMMMMMMMMMMMMMMM
M................
M...MMMMMMMMMMMMM
M................
MMMMMMMMMMMMMMMMM