MMMMMMMMMMMMMMMMMMMMMMMMMMMMMM
M.............................
M...MMMMMMMMMMMMMMMMMMMMMMMMMM
M.............................
MMMMMMMMMMMMMMMMMMMMMMMMMMMMMM